map
000000000000000
000000001000000
000000000000000
000000000000000
000002000000200
000000000000000
000000000200000
000000000000000
000020000001000
000000100000100
000000000000000
000000100000000
000000000000000
010100010100100
000000000000000

team1
ff01abec 4 11
a6629044 3 8
8d1f45fb 13 6

team2
34a908a1 6 1
8d90ac44 11 1
9c86ec09 13 11

territory 7
wall 2
castle 20

turns 100
time 15
