map
11111111111
11111111111
11110111111
11111111111
11122211111
11111122211
11111111111
11111111111
11111111101
11111111111
11110111111
11111111111
11111111111
team1
2 2
1 3
5 5
team2
6 5
7 7
7 5