map
10000000000
00000000000
00001000000
00000000000
00022200000
00000022200
00000000000
00000000000
00020000010
00000000000
00001000000
00000000000
00000000000

team1
2 2
0 3
5 5

team2
6 5
7 7
7 5

territory 5
wall 2
castle 30

turns 100
time 10