map
00000000000000000000
00000000000000000000
00000200000002000000
00000000000000000000
00000000000000000000
00000000000000000000
00000111111100000000
00000111110000000000
00000000000000200000
00000000000000000000
00000011111100000000
00000011111000000000
00000000000000000000
00000000000020000000
00002000011111100000
00000000011111000000
00011100000000000000
00011100200000000000
00000000000000000000
00000000000000000000

team1
2 5
3 5
2 7

team2
16 5
18 7
16 4

territory 5
wall 2
castle 30

turns 100
time 10