map
0000000000000000
0000010000000000
0000000001200000
0000012000000000
0000010000000010
0000000100000000
0000000000000000
0000000000000000
0100000000001000
0000000000020010
0001000000000000
0000100000000100
0000000000000000

team1
440891e4 8 1
7d735933 11 7
daf0e3e3 9 9

team2
befcb738 5 8
4e00b6ec 6 4
5ccbf621 2 8

territory 5
wall 1
castle 12

turns 50
time 5
